-------------------------------------
Cognitively - позновательно
Comprehensible input == is language input
-------------------------------------
Fam - friend, bro	#american english
-------------------------------------
Stand 10 toeas down - always going to stay upright, never going tobidge
-------------------------------------
Traversal - обход
-------------------------------------
cap - lie
clout - popularity, fame
-------------------------------------
descendant - потомок
do long hourses - work for a long time
drain = осушать
duly - according what is required
duly noted - принято к сведению
-------------------------------------
immersion - погружение
implement - реалізувати
implemented - реалізовано
involves - влючает в себя
iterative == repeating
-------------------------------------
lack - недостаток
-------------------------------------
muzzle - наморник
-------------------------------------
occurrence - появление
-------------------------------------
prolific - продуктивный, плодородный
property - свойство, собственность
-------------------------------------
retrieve - забрать, извлекать
-------------------------------------
self-taught - самоучка
southpaw - left-handed boxer
substitute - заменить
-------------------------------------
that can be understood by listeners despite
them not understanding all the words and structures in it
to budge - move from this place, сдаигаться с места
to consider - принимать за, считать
to wind   - разматывать
type shit - someting good, or like etc. common
-------------------------------------
unconscious - без сознания
undoubtaly - несомненно
-------------------------------------
yank - дернуть
